00023465432000
00011111111000
00000000000000
21000000000012
31000000000013
41000000000014
51000000000016
61000000000015
41000000000014
31000000000013
21000000000012
00000000000000
00011111111000
00023456432000